......#####################..........#############
......#####################..........#############
......#####################..........#############
......####################...........#############
......####################............############
.......###################............############
.......##################.............############
........#################..............###########
.........###############................##########
..........#############..................#########
............########........................######
..................................................
